4 6 7 6 7 4 4 7 6 4 7 6 6 7 4 4 7 6 4 7 6 7 4 6 7 4 6 6 4 7 4 4 6 6 4 7 4 6 6 7 7 4 4 7 6 6 4 6 7 4 
4 7 4 6 6 7 7 4 4 7 6 6 4 6 7 4 6 7 6 7 4 4 7 6 4 7 6 6 7 4 4 7 4 6 7 4 6 6 4 7 4 4 6 6 4 6 7 4 4 6 
4 4 4 6 6 4 6 7 4 4 6 7 6 6 7 4 4 7 6 4 7 6 7 4 6 7 4 6 6 7 7 4 4 7 6 6 4 6 7 4 6 7 6 7 4 6 7 4 6 7 
4 7 6 6 4 7 0 0 0 0 0 0 0 0 0 0 0 0 0 0 0 0 9 0 0 0 0 0 0 0 0 0 0 9 0 0 0 0 0 0 8 0 0 0 0 0 6 4 7 4 
4 6 7 7 6 4 0 2 2 2 2 2 2 2 2 0 0 0 9 8 0 0 0 0 0 0 0 0 0 8 0 0 0 0 0 0 0 0 0 0 0 0 0 0 9 0 6 7 4 6
7 6 4 6 7 4 0 2 2 2 2 2 2 2 2 9 0 0 0 0 0 0 0 0 9 0 0 0 0 0 0 0 0 8 0 0 0 0 9 0 0 0 0 0 0 0 7 4 6 4  
7 6 4 6 4 7 0 2 2 2 2 2 2 2 2 0 0 0 0 0 0 0 8 0 0 0 0 0 0 0 9 0 0 0 0 0 0 0 0 0 0 0 0 8 0 0 4 6 4 7
7 6 4 6 4 7 0 2 2 2 2 2 2 2 0 0 0 0 9 0 0 0 0 0 0 0 0 0 0 0 0 0 0 0 0 0 8 0 0 0 8 0 0 0 0 0 6 4 6 7 
7 6 4 6 4 7 0 2 2 2 2 2 2 0 0 1 1 1 1 1 1 1 28 1 1 1 1 1 1 1 28 1 1 1 1 1 1 1 0 9 0 0 0 0 0 0 7 4 6 7  
7 6 4 6 4 7 0 0 0 0 9 5 0 9 0 1 20 20 20 20 20 3 3 3 22 23 23 23 24 3 3 3 20 20 20 20 20 1 0 0 0 0 0 0 8 0 4 6 7 4  
7 6 4 6 4 7 0 0 8 0 0 5 0 0 0 1 20 20 20 20 20 3 3 3 27 26 26 26 25 3 3 3 20 20 20 20 20 1 0 0 0 0 0 0 0 9 4 6 7 4   
7 6 4 6 4 7 0 9 0 0 0 5 0 0 8 1 3 3 3 3 3 3 3 3 3 3 3 3 3 18 3 3 3 3 3 3 3 1 9 0 8 0 0 0 0 0 4 6 7 4   
7 6 4 6 4 7 0 0 0 0 0 5 0 0 0 1 3 3 3 3 3 3 3 3 3 3 3 3 3 19 3 3 3 3 3 3 3 1 0 0 0 0 0 9 0 0 4 6 7 4   
7 6 4 6 4 7 0 0 0 9 0 5 0 0 0 1 3 3 30 3 3 3 29 3 29 3 29 3 29 3 29 3 3 3 3 3 3 1 0 0 0 0 0 0 8 0 4 6 7 4   
7 6 4 6 4 7 0 0 0 0 8 5 0 0 0 1 3 3 3 3 3 3 31 3 31 3 3 3 31 3 31 3 3 3 30 3 3 1 0 8 0 9 0 0 0 0 4 6 7 4   
7 6 4 6 4 7 0 0 0 0 0 5 0 9 0 1 3 3 3 3 3 3 29 3 29 3 29 3 29 3 29 3 3 3 3 3 3 1 0 0 8 0 0 0 0 9 4 6 7 4   
7 6 4 6 4 7 0 0 0 5 5 5 0 0 8 1 3 3 3 3 3 3 31 3 31 3 31 3 31 3 31 3 3 3 3 3 3 1 9 0 0 0 0 0 0 0 4 6 7 4   
7 6 4 6 4 7 0 0 8 5 0 0 0 0 0 1 32 32 32 32 32 32 32 32 32 3 3 3 32 32 32 32 32 32 32 32 32 1 0 0 0 0 0 0 8 0 4 6 7 4   
7 6 4 6 4 7 0 9 0 5 0 0 0 9 0 1 1 1 1 1 1 1 1 1 1 3 3 3 1 1 1 1 1 1 1 1 1 1 0 0 9 8 0 0 0 0 7 4 6 7 
7 6 4 6 4 7 0 0 0 5 0 8 0 0 0 0 0 0 0 0 0 0 0 0 0 0 5 0 0 0 0 0 0 0 0 0 0 0 8 0 9 0 0 0 0 0 4 6 4 7 
7 6 4 6 4 7 0 8 0 5 0 9 0 0 0 0 0 0 0 0 0 0 0 0 0 0 5 0 0 0 0 0 0 0 0 0 0 0 0 0 0 0 0 0 9 0 4 6 4 7 
7 6 4 6 4 7 0 0 0 5 5 5 5 5 5 5 5 5 5 5 5 5 5 5 5 5 5 5 5 5 5 5 5 5 5 5 5 5 5 5 5 5 0 0 0 0 4 6 4 7 
7 6 4 6 4 7 0 0 0 0 0 0 0 0 0 0 0 0 0 0 0 0 0 0 0 0 5 0 0 0 0 0 0 0 0 0 0 0 0 0 0 0 0 0 0 0 4 6 4 7 
4 6 7 6 4 0 0 0 0 0 0 0 0 0 0 0 0 0 0 0 0 0 0 0 0 0 5 0 0 0 0 0 0 0 0 0 0 0 0 0 0 0 0 0 0 0 0 7 6 4 
6 7 4 4 0 0 0 0 0 0 0 0 0 0 0 0 0 0 0 0 0 0 0 0 0 0 5 0 0 0 0 0 0 0 0 0 0 0 0 0 0 0 0 0 0 0 0 0 7 6 
7 4 6 0 0 0 0 0 0 0 0 0 0 0 0 0 0 0 0 0 0 0 0 0 0 0 5 0 0 0 0 0 0 0 0 0 0 0 0 0 0 0 0 0 0 0 0 0 0 4 
6 4 0 0 0 0 0 0 0 0 0 0 0 0 0 0 0 0 0 0 0 0 0 0 0 0 5 0 0 0 0 0 0 0 0 0 0 0 0 0 0 0 0 0 0 0 0 0 0 6 
4 0 0 0 0 0 0 0 0 0 0 0 0 0 0 0 0 0 0 0 0 0 0 0 0 0 5 0 0 0 0 0 0 0 0 0 0 0 0 0 0 0 0 0 0 0 0 0 0 4 
6 0 0 0 0 0 0 0 0 0 0 0 0 0 0 0 0 0 0 0 0 0 0 0 0 0 5 0 0 0 0 0 0 0 0 0 0 0 0 0 0 0 0 0 0 0 0 0 0 6 
4 0 0 0 0 15 15 15 15 15 15 15 15 0 0 0 0 0 0 0 0 0 0 0 0 0 5 0 0 0 0 0 0 0 0 15 15 15 15 15 15 15 15 0 0 0 0 0 0 7 
7 15 15 15 15 15 15 15 15 15 15 15 15 15 15 15 15 15 15 15 15 15 15 15 15 15 5 15 15 15 15 15 15 15 15 15 15 15 15 15 15 15 15 15 15 15 15 15 15 6
6 15 15 15 15 15 15 15 15 15 15 15 15 15 15 15 15 15 15 15 15 15 15 15 15 15 5 15 15 15 15 15 15 15 15 15 15 15 15 15 15 15 15 15 15 15 15 15 15 7
14 14 14 14 14 14 14 14 14 14 14 14 14 14 14 14 14 14 14 14 14 14 14 15 15 15 5 15 15 15 14 14 14 14 14 14 14 14 14 14 14 14 14 14 14 14 14 14 14 14
2 2 2 2 2 2 2 2 2 2 2 2 2 2 2 2 2 2 2 2 2 2 2 2 2 16 16 16 2 2 2 2 2 2 2 2 2 2 2 2 2 2 2 2 2 2 2 2 2 2
2 2 2 2 2 2 2 2 2 2 2 2 2 2 2 2 2 2 2 2 2 2 2 2 2 16 16 16 2 2 2 2 2 2 2 2 2 2 2 2 2 2 2 2 2 2 2 2 2 2 
2 2 2 2 2 2 2 2 2 2 2 2 2 2 2 2 2 2 2 2 2 2 2 2 2 16 16 16 2 2 2 2 2 2 2 2 2 2 2 2 2 2 2 2 2 2 2 2 2 2
2 2 2 2 2 2 2 2 2 2 2 2 2 2 2 2 2 2 2 2 2 2 2 2 2 16 16 16 2 2 2 2 2 2 2 2 2 2 2 2 2 2 2 2 2 2 2 2 2 2
2 2 2 2 2 2 2 2 2 2 2 2 2 2 2 2 2 2 2 2 2 2 2 2 2 16 16 16 2 2 2 2 2 2 2 2 2 2 2 2 2 2 2 2 2 2 2 2 2 2
2 2 2 2 2 2 2 2 2 2 2 2 2 2 2 2 2 2 2 2 2 2 2 2 2 16 16 16 2 2 2 2 2 2 2 2 2 2 2 2 2 2 2 2 2 2 2 2 2 2
2 2 2 2 2 2 2 2 2 2 2 2 2 2 2 2 2 2 2 2 2 2 2 2 2 16 16 16 2 2 2 2 2 2 2 2 2 2 2 2 2 2 2 2 2 2 2 2 2 2
2 2 2 2 2 2 2 2 2 2 2 2 2 2 2 2 2 2 2 2 2 2 2 2 2 16 16 16 2 2 2 2 2 2 2 2 2 2 2 2 2 2 2 2 2 2 2 2 2 2
2 2 2 2 2 2 2 2 2 2 2 2 2 2 2 2 2 2 2 2 2 2 2 2 2 16 16 16 2 2 2 2 2 2 2 2 2 2 2 2 2 2 2 2 2 2 2 2 2 2
2 2 2 2 2 2 2 2 2 2 2 2 2 2 2 2 2 2 2 2 2 2 2 2 2 16 16 16 2 2 2 2 2 2 2 2 2 2 2 2 2 2 2 2 2 2 2 2 2 2
2 2 2 2 2 2 2 2 2 2 2 2 2 2 2 2 2 2 2 2 2 2 2 2 2 2 2 2 2 2 2 2 2 2 2 2 2 2 2 2 2 2 2 2 2 2 2 2 2 2
2 2 2 2 2 2 2 2 2 2 2 2 2 2 2 2 2 2 2 2 2 2 2 2 2 2 2 2 2 2 2 2 2 2 2 2 2 2 2 2 2 2 2 2 2 2 2 2 2 2
2 2 2 2 2 2 2 2 2 2 2 2 2 2 2 2 2 2 2 2 2 2 2 2 2 2 2 2 2 2 2 2 2 2 2 2 2 2 2 2 2 2 2 2 2 2 2 2 2 2
2 2 2 2 2 2 2 2 2 2 2 2 2 2 2 2 2 2 2 2 2 2 2 2 2 2 2 2 2 2 2 2 2 2 2 2 2 2 2 2 2 2 2 2 2 2 2 2 2 2
2 2 2 2 2 2 2 2 2 2 2 2 2 2 2 2 2 2 2 2 2 2 2 2 2 2 2 2 2 2 2 2 2 2 2 2 2 2 2 2 2 2 2 2 2 2 2 2 2 2
2 2 2 2 2 2 2 2 2 2 2 2 2 2 2 2 2 2 2 2 2 2 2 2 2 2 2 2 2 2 2 2 2 2 2 2 2 2 2 2 2 2 2 2 2 2 2 2 2 2
2 2 2 2 2 2 2 2 2 2 2 2 2 2 2 2 2 2 2 2 2 2 2 2 2 2 2 2 2 2 2 2 2 2 2 2 2 2 2 2 2 2 2 2 2 2 2 2 2 2